00000000000000000000000000000000000000000000000000
00000000000000000000000000000000000000000000000000
00000000000000000000000000000000000000000000000000
00000000000000000000000000000000000000000000000000
00030000000000000000000000000000000000000000000000
00010000000000000000000000000000000000000000000000
00010000000000000000000000000000000000000000000000
00010000000000000000000000000000000000000000000000
00010000000000000000000000000000000000000000000000
00010000000000000000000000000000000000000000000000
00010000000000000000000000000000000000000000000000
00010000000000000000000000000000000000000000000000
00011111111111111111111111111111111111000000000000
00000000000000001000000000000000000001000000000000
00000000000000000000000000000000000001000000000000
00000000000000000000000000000000000001000000000000
00000000000000000000000000000000000001000000000000
00000000000000000000000000000000000001000000000000
00000000000000000000000000000000000001100000000000
00000000000000000000000000000000000000100000000000
00000000000000000000000000000000000000100000000000
00000000000000000000000000000000000000100000000000
00000000000000000000000000000000000000100000000000
00000000002000000000000000000000000001100000000000
00000000001000000000000000000000000001000000000000
00000000001000000000000000000000000001000000000000
00000000001000000000000000000000000001000000000000
00000000001100000000000000000000000001100000000000
00000000000100000000000000000000000000100000000000
00000000001100000000000000000000000000100000000000
00000000001000000000000000000000000000100000000000
00000000001111111111111111111111111111100000000000
00000000000000000000000000000000000000000000000000
