00000000000000000000000000000000000000000000000000
03001111000000000000000000000000000000000000000000
01001001000000000000000000000000000000000000000000
01001001000000000000000000000000000000000000000000
01001001000111111111000000000000000000000000000000
01001001000100000001000000000000000000000000000000
01001001000100000001000000000000000000000000000000
01001001000100000001000000000000000000000000000000
01001001000100000001000000000000000000000000000000
01001001000100000001000000000000000000000000000000
01001001000100000001000000000000000000000000000000
01001001000100000001000000000000000000000000000000
01001001000100000001000000000000000000000000000000
01001001000100000001000000000000000000000000000000
01001001000100000001000000000000000000000000000000
01001001001100000001000000000000000000000000000000
01001001000111100001000000000000000000000000000000
01001001000000100001000000000000000000000000000000
01001011000000100001000000000000000000000000000000
01001001000000100001000000000000000000000000000000
01001001000000100001000000000000000000000000000000
01001001000000100001000000000000000000000000000000
01001001000000100001000000000000000000000000000000
01001001000000100001000000000000000000000000000000
01001001000000100001000000000000000000000000000000
01001001000000100001110000000000000000000000000000
01001001000000100000010000000000000000000000000000
01001001000000100000000000000000000000000000000000
01001011000000100000000000000000000000000000000000
01001011000000100000000000000000000000000000000000
01001011000000110000000000000000000000000000000000
01001001000000011000000000000000000000000000000000
01001001000000001110000000000000000000000000000000
01001001000000000010000000000000000000000000000000
01001001000000000010000000000000000000000000000000
01111001111111000010000000000000000000000000000000
00000000000001100010000000000000000000000000000000
00000000000000110010000000000000000000000000000000
00000000000000011110000000000000000000000000000000
00000000000000000000000000000000000000000000000000
00000000000000000000000000000000000000000000000000
00000000000000000000000000000000000000000000000000
00000000000000000000000000000000000000000000000000
00000000000000000000000000000000000000000000000000
00000000000000000000000000000000000000000000000000
00000000000000000000000000000000000000000000000000
00000000000000000000000000000000000000000000000000
00000000000000000000000000000000000000000000000000
00000000000000000000000000000000000000000000000000
00000000000000000000000000000000000000000000000000
